

	NO         ./textures/test.xpm
 

C 225,30,0

SO ./textures/test.xpm


EA    ./textures/test.xpm
WE ./textures/test.xpm

F 220,100,0

111111111111111
100000000000001
101110111011101
101010101010101
1000N0000000001
101010101010101
101010101010101
100000000000001
111111111111111

