
	NO         ./textures/test.xpm
 

C 32,43,99999999999999999999  

SO ./textures/test.xpm

lol 

                     			EA    ./textures/test.xpm
WE 					./textures/test.xpm

F 220,1000,	


11111111111
1E000000001111111
11111111111111


