

	NO         ./path_to_the_north_texture
 

C 225,30,0

SO ./path_to_the_south_texture


EA    ./path_to_the_east_texture
WE ./path_to_the_west_texture

F 220,100,0




  11111111     111111111    
 110N01111
  1111101101  1
  111111111







           1111111111111111111111111
           10001     110000000000001
          11110111111100000000000011
          10010000000000000000000011
  111111111011000001110000000000001
  100000000011000001110111111111111
  11110111111111011100000010001    
  11110111110111011101010010001                     
  110000001101010111000N0010001
  10000000000000001100000010001    
  10000000000000001101010010001    
  111111111111111111111111111111  


  11110111 1110101 101111010001    
  11111111 1111111 111111111110    


dfsvidfv

476

