NO ./textures/square/patrick.xpm
SO ./textures/square/carlo.xpm
EA ./textures/square/bob.xpm
WE ./textures/square/plancton.xpm
 
C               32,0,78
F 220,100,0


11111111111111111111111111111111111111
10101010101010101011010101010101010101
1W000000000000000000000000000000000001
10101010101010101011010101010101010101
11111111111111111111111111111111111111

111111111
100000001
1000N0001
100000001
111111111