NO ./textures/bob/bob.xpm
SO ./textures/bob/carlo.xpm
EA ./textures/bob/pinapple.xpm
WE ./textures/bob/patrick.xpm
 
C 149,242,223
F 229,241,217

1111111111111111111111111111
1010101010101010101101010101
1000000000000001000000000001
1000000000000000100000000001
1000000000000W00010000000001
1000000000000000001000000001
1010101010101010101101010101
1111111111111111111111111111