NO ./textures/bob2/bob.xpm
SO ./textures/bob2/carlo.xpm
EA ./textures/bob2/pinapple.xpm
WE ./textures/bob2/patrick.xpm
WE ./textures/bob2/patrick.xpm
 
C 149,242,223
F 229,241,217


11111111111111111111111111111111111111
10101010101010101011010101010101010101
1W000000000000000000000000000000000001
10101010101010101011010101010101010101
11111111111111111111111111111111111111