NO ./textures/bob2/bob.xpm
SO ./textures/bob2/carlo.xpm
EA ./textures/bob2/pinapple.xpm
WE ./textures/bob2/patrick2.xpm
 
C 149,242,223
F 229,241,217


1111111111111111111111111111
1010101010101010101101010101
1000000000000000000000000001
1000000000000000000000000001
1000000000000W00000000000001
1000000000000000000000000001
1010101010101010101101010101
1111111111111111111111111111