NO ./textures/ethan/patrick.xpm
SO ./textures/ethan/carlo.xpm
EA ./textures/ethan/bob.xpm
WE ./textures/ethan/plancton.xpm
 
C               32,0,78
F 220,100,0


11111111111111111111111111111111111111
10000010101010101011010101010101010101
1E010000000000000000000000000000000001
10000010101010101011010101010101010101
11111111111111111111111111111111111111