C 0,0,255
F 255,255,0
NO ./textures/collectible.xpm
EA ./textures/open_exit.xpm
WE ./textures/player.xpm
SO ./textures/hidden_exit.xpm

11111111111111111111111111111111111111111111111111111111111111111111111111111111111111111
10000000000000000000000000000000000000000000000000000000000000000000000000000000000000001
10111011101110111011101110111011101110111011101110111011101110000000000000000000000000001
10101010101010101010101010101010101010101010101010101010101010000000000000000000000000001
1E000000000000000000000000000000000000000000000000000000000000000000000000000000000000001
10100010000100100010001010100010001010100010001010100010001010000000000000000000000000001
10001000100010001000100010001000100010001000100010001000100010000000000000000000000000001
10000000000000000000000000000000000000000000000000000000000000000000000000000000000000001
11111111111111111111111111111111111111111111111111111111111111111111111111111111111111111

