C 0,0,255
F 255,255,0
NO ./textures/collectible.xpm
EA ./textures/open_exit.xpm
WE ./textures/player.xpm
SO ./textures/hidden_exit.xpm

111111111111111
100000000000001
101110111011101
101010101010101
1E0000000000001
101010101010101
100010101010101
100000000000001
111111111111111

