C 0,0,255
F 255,255,0
NO ./textures/collectible.xpm
EA ./textures/open_exit.xpm
WE ./textures/player.xpm
SO ./textures/hidden_exit.xpm

1111111111111111111111111111111111111111111111111111111111111111111111111111111111
1000000000000000000000000000000000000000000000000000000000000000000000000000000001
1011101110111011101110111011101110111011101110111011101110111000000000000000000001
1010101010101010101010101010101010101010101010101010101010101000000000000000000001
1E00000000000000000000000000000000000000000000000000000000000000000000000000000001
1010001000101010001000101010001000101010001000101010001000101000000000000000000001
1000100010001000100010001000100010001000100010001000100010001000000000000000000001
1000000000000000000000000000000000000000000000000000000000000000000000000000000001
1111111111111111111111111111111111111111111111111111111111111111111111111111111111

