NO ./textures/bob/bob.xpm
SO ./textures/bob/carlo.xpm
EA ./textures/bob/pinapple.xpm
WE ./textures/bob/patrick.xpm
 
C 149,242,223
F 229,241,217

 1111111111111111111111111111111111111111111111111111111111111111111111111111111111111111
10000000000000000000000000000000000000000000000000000000000000000000000000000000000000001
10111011101110111011101110111011101110111011101110111011101110000000000000000000000000001
1010101 101010101010101010101010101010101010101010101010101010000000000000000000000000001
1N000001000000000000000000000000000000000000000000000000000000000000000000000000000000001
10100000100100100010001010100010001010100010001010100010001010000000000000000000000000001
10001001000010001000100010001000100010001000100010001000100010000000000000000000000000001
10000000000000000000000000000000000000000000000000000000000000000000000000000000000000001
10000000000000000000000000000000000000000000000000000000000000000000000000000000000000001
11111111111111111111111111111111111111111111111111111111111111111111111111111111111111111

