NO ./textures/bob/bob.xpm
SO ./textures/bob/carlo.xpm
EA ./textures/bob/pinapple.xpm
WE ./textures/bob/patrick.xpm
 
C 149,242,223
F 229,241,217

 1111111111111111111111111111111111111111111111111111111111111111111111111111111111111111
10000000000000000000000000000000000000000000000000000000000000000000000000000000000000001
100000000000000000000000000000000001110111011101110111011101110000000000000000000000000001
100000000000000000000000000000000001010101010101010101010101010000001100000000000000000001
1N000000000000000000000000000000000000000000000000000000000000000001  10000000000000000001
10000100100000000000000000000000000101010001000101010001000101000001  10000000000000000001
10001000010000000000000000000000000001000100010001000100010001000000110000000000000000001
10000000000000000000000000000000000000000000000000000000000000000000000000000000000000001
10000000000000000000000000000000000000000000000000000000000000000000000000000000000000001
11111111111111111111111111111111111111111111111111111111111111111111111111111111111111111

