NO ./textures/bob/bob.xpm
SO ./textures/bob/carlo.xpm
EA ./textures/bob/pinapple.xpm
WE ./textures/bob/patrick.xpm
 
C 149,242,223
F 229,241,217

    1111111111111111111111111111111 
   100000000000000000000000000000001
  10000000000000111000000000000000001
 1000000000000001010000011000000000001
1N0000000000000000000001  1000000000001
100000100100000010100001  1000000000001
 1000100001000000010000011000000000001
  10000000000000000000000000000000001
   100000000000000000000000000000001
    1111111111111111111111111111111 

