NO ./textures/bob/bob.xpm
SO ./textures/bob/carlo.xpm
EA ./textures/bob/pinapple.xpm
WE ./textures/bob/patrick.xpm
 
C 149,242,223
F 229,241,217


111111
 1E0001
 100001
 100001
 10001
  1001                                                             
   1001                                                           
    1001                                                         
     1001                                                       
      1001                                                     
       1001                                                   
        1001                                                 
         1001                                               
          1001                                             
           1001                                           
            101
            101
            101
            101
            101
            101
            101
            101
            101
            101
            101
            101
            101
            1011111
            1000000
            1111111