

	NO         ./textures/collectible.xpm
 

C               32,0,78

SO ./textures/hidden_exit.xpm


EA    ./textures/open_exit.xpm
WE ./textures/player.xpm

F 220,100,0


11111111111111111111111111111111111111
10000000000000000000000000000000000001
10000000000000000000000000000000000001
10000000000000000000000000000000000001
10000000000000000000000000000000000001
10000000000000000000000000000000000001
100000000000000000N0000000000000000001
10000000000000000000000000000000000001
10000000000000000000000000000000000001
10000000000000000000000000000000000001
10000000000000000000000000000000000001
10000000000000000000000000000000000001
10000000000000000000000000000000000001
11111111111111111111111111111111111111

11111111111111111111111111111111111111
10101010101010101011010101010101010101
1E000000000000000000000000000000000001
10101010101010101011010101010101010101
11111111111111111111111111111111111111

  11111111     111111111    
 110E000011
  1111101111  1
  111111111







           1111111111111111111111111
           10001     110000000000001
          11110111111100000000000011
          10010000000000000000000011
  111111111011000001110000000000001
  100000000011000001110111111111111
  11110111111111011100000010001    
  11110111110111011101010010001                     
  110000001101010111000N0010001
  10000000000000001100000010001    
  10000000000000001101010010001    
  111111111111111111111111111111  


  11110111 1110101 101111010001    
  11111111 1111111 111111111110    


dfsvidfv

476

