C 0,0,255
F 255,255,0
NO ./textures/collectible.xpm
EA ./textures/open_exit.xpm
WE ./textures/player.xpm
SO ./textures/hidden_exit.xpm

1111
1E01
1111
