NO ./textures/square/patrick.xpm
SO ./textures/square/carlo.xpm
EA ./textures/square/bob.xpm
WE ./textures/square/plancton.xpm
 
C              0,0,0



F  0,0,0


11111111111111111111111111111111111111
1W000000000000000000000000000000000001
10000000000000000000000000000000000001
10000000000000000000000000000000000001
10000000000000000000000000000000000001
10000000000000000000000000000000000001
10000000000000000000000000000000000001
10000000000000000000000000000000000001
10000000000000000000000000000000000001
11111111111111111111111111111111111111
